NO ././textures/path_to/path_to_north_texture.xpm
SO ././textures/path_to/path_to_south_texture.xpm
WE ././textures/path_to/path_to_west_texture.xpm
EA ././textures/path_to/path_to_east_texture.xpm

F 255,255,255
C 0,0,0

1111111111111
1000000000001
1000111000001
1000101000001
1000E01000001
1000101000001
1000111000001
1000000000001
1111111111111
