NO ././textures/path_to/path_to_north_texture.xpm



SO ././textures/path_to/path_to_south_texture.xpm

WE ././textures/path_to/path_to_west_texture.xpm


EA ././textures/path_to/path_to_east_texture.xpm

F 50,100,150


C 200,180,160


1111111
1000001
100N001
1000001
1111111
