NO ././textures/path_to/path_to_north_texture.xpm
SO ././textures/path_to/path_to_south_texture.xpm
WE ././textures/path_to/path_to_west_texture.xpm
EA ././textures/path_to/path_to_east_texture.xpm

F 128,64,32
C 100,150,200

1111
1W01
1001
1111
