NO textures/simonkraft/wet_sponge.png
SO textures/simonkraft/wet_sponge.png
WE textures/simonkraft/wet_sponge.png
EA textures/simonkraft/wet_sponge.png

F randomText 164,169,20
C 153,204,255

111111111
100000001
101111101
100N00001
111111111
